02 02 03 04 05 02 03 04 05 05
12 13 14 15 12 13 14 15 12 13
12 13 14 15 12 13 14 15 12 13
12 13 14 15 12 13 14 15 12 13
12 13 14 15 12 13 14 15 12 13
12 13 14 15 12 13 14 15 12 13
52 52 53 54 55 52 53 54 55 55